111111111111111111111111111111
100000000000001000000000000001
101110011010111000101010101101
100000001000011000101010101001
101011001000001000001010000001
100000011010111001001010000001
101101000000000010011110001001
100000000010000001000000000001
101011000010010001000000011001
100000000010000010000100000001
101001100000010000110000010001
100000000111111100000100000001
100010000000010000000000001001
100000000100010001000000100001
100010001011111000101000101001
100000000000001000000000000001
111111111111111111111111111111
