+-------------------------------------------------+
|                                                 |
|     ------|     -----|        | -+  |---------  |
| |         |          |   ------  |  |           |
| |         |          |        |  |  |     +  |  |
| |   ------|     -----|   --+  |     |     |  |  |
| |           +-             |  |     |     |  |  |
| |           |  -----| -+ | |  |  |  |  |  |  |  |
| |   ------| |       |  | | |  |  |  |  |     |  |
|           | |       |  | | |  |  |  |  |     |  |
|----       | |  -----|  | | |  |  |  |  |     |  |
|     ------|            | | |  |  |  |  |  |  |  |
| |              +------   |    |  |  |  |  |  |  |
| | -----------  |         -----|  |  |  |  |  |  |
|       |                       |  |  |  |  |  |  |
|    |  | -------   ---+ +---      |  |  |  |  |  |
|  --+  |              | |         |  |  | -+  |  |
|       |----------  | | |  +-   | |     |     |  |
|                    | | |  |    | |     |  +-    |
| |  |   ---------+  | | |  |    | |     |  |  |  |
| |  |            |  |           |          |  |  |
|    +---------   |  +------     +----   ------+  |
|                                                 |
+-------------------------------------------------+
