111111111111111111111111111111
100000000000000000000000000001
101110001010111000101000101101
100010001000011000101000101001
101011000000000000001000000001
100000001010011001000000000001
101101000000000000010010001001
100000000010000001000000000001
101011000010011001000000011001
100000000010000000000100000001
101000100000000000110000010001
100000000100011100000100000001
100010000000000000000000001001
100000000100000001000000100001
100010001000011000101000101001
100000000000000000000000000001
111111111111111111111111111111
